%%%%%%%%%%%%%%%%%%%%%%%%%%%%%%%%
%   %. %.%.%       %     % % %4%
% % %%       %%  %   %%%   % %2%
% % %. % %%%    %%%%  %  % % % %
% % %% % ..% %   %   %%%%% % % %
% %    %%%%% %%%   %%% %   % % %
% %% % ..%.  %.%%%       %   % %
% %. %%.%%%%        % %%%%  %% %
% %%  %%%%.%        %%%% %%  % %
% %   %       %%%.% ..%   % %% %
% % % o %.%%%   %%% %%%%%    % %
% % % %%%%%   %   % %   % %% % %
% % % %..%. %%%%    %%% %  % % %
%1%.%   %%%   %  %%       %% % %
%3%.%.%     %       % % %  %   %
%%%%%%%%%%%%%%%%%%%%%%%%%%%%%%%%